urlHelp=help/index.html
lastSaved=上次保存
currentFile=当前文件
toolbar=工具栏
save=保存
print=打印
cut=剪切
copy=复制
paste=粘贴
delete=删除
undo=撤销
redo=重做
select=选中
connect=连接
pan=平移
zoomIn=放大
zoomOut=缩小
zoom=缩放
fit=适合大小
actualSize=实际大小
selectAll=选中全部
clearSelection=清空选中
shape=形状
format=格式
font=字体
group=分组
ungroup=取消分组
removeFromParent=从父级移除
align=对齐
left=左对齐
right=右对齐
center=水平居中
top=顶端对齐
middle=垂直居中
bottom=底端对齐
collapse=折叠
expand=展开
toBack=向后
toFront=向前
enterGroup=进入分组
exitGroup=退出分组
layout=布局
horizontalTree=水平树状布局
verticalTree=垂直树状布局
fillColor=填充颜色
strokeColor=线条颜色
gradientColor=渐变色
bold=粗体
italic=斜体
fontColor=字体颜色
fontSize=字体大小
fontFamily=字体
examples=示例
newDiagram=新图像
image=图片
opacity=不透明度
selection=已选中
editStyle=编辑样式
enterStyle=输入样式
enterColorname=输入颜色名
enterImageUrl=输入图片URL
enterOpacity=输入不透明度(%)
enterFontsize=输入字体大小(pt)
enterFontfamily=输入字体
toggleRounded=圆角
toggleShadow=阴影
toggleOrientation=方向
openHref=打开URL
show=显示
exportImage=导出图片
exportSvg=导出SVG
changesLost=所有更改都将丢失!
swimlanes=泳道
travelBooking=旅游预订
notAvailable=不可用
